1111111111111111111111111111111111111111111111111111111111111111111
1P0000000000000000000000C00000000000000001E10000000000000000000001
1011111111111011111111111101111111111111111111111111111111011111101
1000000000010000000000000100000000000000000000000000000001000000001
1000111111010111101111110101111111111111111111111011111111011111101
1000100000010000101000000101000000000000000010001000000001000000001
1000101111010000101011111101011111111111111010101011111111010111111
1000101000010000101000000101000000000000001010101000000000010100001
1000101011111110101111101101011111101111111010101111110111010101011
1000101000000000100000101001000000100000000010100000100000010100011
1000111011111111101110101111011110101111111010111101101111110101011
1000000010000000000010100000000000100000000000000100000000000100001
1011111010111111111010111111111111101110111111111101111111111101111
1000000010100000000010000000000000100000100000000000000000000100001
1001111110111111111010111111111111101110111110111111111111111101111
1001000000000000000000100000000000100000000000110000000000000100001
1001011111111111111101111111111111101110111110111111111111111101111
1001000000000000000000000000000000000000000000110000000000000000001
1001111111111111111111111111111111111111111111111111111111111111111
1001000000000000000000000000000000000000000000110000000000000000001
1001011111111111111101111111111111101110111110111111111111111101111
1001000000000000000000100000000000100000000000110000000000000100001
1001111110111111111010111111111111101110111110111111111111111101111
1000000010100000000010000000000000100000100000000000000000000100001
1011111010111111111010111111111111101110111111111101111111111101111
1000000010000000000010100000000000100000000000000100000000000100001
1000111011111111101110101111011110101111111010111101101111110101011
1000101000000000100000101001000000100000000010100000100000010100011
1000101011111110101111101101011111101111111010101111110111010101011
1000101000010000101000000101000000000000001010101000000000010100001
1000101111010000101011111101011111111111111010101011111111010111111
1000100000010000101000000101000000000000000010001000000001000000001
1000111111010111101111110101111111111111111011111011111111011111101
1000000000010000000000000100000000000000000000000000000000000000001
1111111111111111111111111111111111111111111111111111111111111111111