111111111111111111111111111111111111
1P0000000000000000000000000000000001
101111111011111111111111101111111101
100000001010000000000001010000000001
101011101010111101111101011111111101
100010001010100000000000000000000001
111110111010101111111111111111111101
100000000000100000000000000C00000001
111111111110101111111101111101111101
100000000010101000000001000001000001
101111111010111111111111011111011101
100000001000000000000000010000000001
101111101111111111111111110111111101
100000000000000000000000000000000001
111111101111111111111111111111101101
1C000000010000000000C000000000000001
101111101111111111111111101111111101
10000000000C0000000000000000000000E1
111111111111111111111111111111111111