11111111111111111111111111111111111111111111111111111111111111111111111111111111
1P000000000000000000000000000000000000000000000000000000000000000000000000000001
10111111101111111111111110111111110000000000000000000000000000000000000000000001
10000000101000000000000101000000000000000000000000000000000000000000000000000001
10101110101011110111110101111111110000000000000000000000000000000000000000000001
10001000101010000000000000000000000000000000000000000000000000000000000000000001
11111011101010111111111111111111110000000000000000000000000000000000000000000001
100000000000100000000000000C0000000000000000000000000000000000000000000000000001
11111111111010111111110111110111110000000000000000000000000000000000000000000001
10000000001010100000000100000100000000000000000000000000000000000000000000000001
10111111101011111111111101111101110000000000000000000000000000000000000000000001
10000000100000000000000001000000000100000000000000000000000000000000000000000001
10111110111111111111111111011111110100000000000000000000000000000000000000000001
10000000000000000000000000000000000100000000000000000000000000000000000000000001
11111110111111111111111111111110110100000000000000000000000000000000000000000001
1C000000010000000000C00000000000000100000000000000000000000000000000000000000001
10111110111111111111111110111111110100000000000000000000000000000000000000000001
10000000000C0000000000000000000000E100000000000000000000000000000000000000000001
11111111111111111111111111111111111111111111111111111111111111111111111111111111
